20
# # # # # # # # # # # # # # # # # # # #
. . # . # # # . . # . . . # . . # . # #
# . # . . # # . # # . # . # # . . . # .
# . # # T . . . # # . # . # . . # . . .
# . # # . # . # . . . # . . # . # # . #
# . . # . # . # . # . . # . . . . . # #
# # . # . # . # . # # . # # # # # . # #
# # . # . # . # . # . . # . . . . . . .
# . . . . # . . . # . # # # . # . . # .
# # . # # # . # # # . # . # . # # . # #
# . . . # . . # . . . # . # . # # . # #
# # . # . . # . . # . # . # . # . . # #
# . # # . # # . # # . # . # . . # . # #
# . . . . # . . # # . # . . # . . # # #
# # . # . # . # . . . . # . . # . . . #
# # . # . # . # # # # . # # . # # # . #
# # . # . # . . # # # . # # . . . . . #
# # # # . # # . # . . . . # # # # . . #
# . . . . . . # # . # # . . . . . # . #
# # # # # # # # # # # # # # # # # # # #